###Map Created with PsychoStrain Map Editor RC3
#
#
XXXXXXXXXXXXXXXXXXXXXXXXXXXXXXXXXXXXXXXXXXXXXXXXXXXXXXXXXXXXXXXXXXXXXXXXXXXXXXXXXXXXXXXXXXXXXXXXXXXXXXXXXXXXXXXXXXXXXXXXXXXXXXXXXXXXXXXXXXXXXXXXXXXXXXXXXXXXXXXXXXXXXXXXXXXXXXXXXXXXXXXXXXXXXXXXXXXXXXXXXXXXXXXXXXXXXXXXXXXXXXXXXXXXXXXXXXXXXXXXXXXXXXXXXXXXXXXXXXXXXXXXXXXXXXXXXXXXXXXXXXXXXXXXXXXXXXXXXXXXXXXXXXXXXXXXXXXXXXXXXXXXXXXXXXXXXXXXXXXXXXXXXXXXXXXXXXXXXXXXXXXXXXXXXXXXXXXXXXXXXXXXXXXXXXXXXXXXXXXXXXXXXXXXXXXXXXXXXXXXXXXXXXXXXXXXXXXXXXXXXXXXXXXXXXXXXXXXXXXXXXXXXXXXXXXXXXXXXXXXXXXXXXXXXXXXXXXXXXXXXXXXXXXXXXXXXXXXXXXXXXXXXXXXXXXXXXXXXXXXXXXXXXXXXXXXXXXXXXXXXXXXXXXXXXXXXXXXXXXXXXXXXXXXXXXXXXXXXXXXXXXXXXXXXXXXXXXXXXXXXXXXXXXXXXXXXXXXXXXXXXXXXXXXXXXXXXXXXXXXXXXXXXXXXXXXXXXXXXXXXXXXXXXXXXXXXXXXXXXXXXXXXXXXXXXXXXXXXXXXXXXXXXXXXXXXXXXXXXXXXXXXXXXXXXXXXXXXXXXXXXXXXXXXXXXXXXXXXXXXXXXXXXXXXXXXXXXXXXXXXXXXXXXXXXXXXXXXXXXXXXXXXXXXXXXXXXXXXXXXXXXXXXXXXXXXXXXXXXXXXXXXXXXXXX
828282828282828282828282828282828282828282828282828282828282828282828282828282828282828282828282828282828282828282828282828282828282828282828282828282828282828282828282828282828282828282828282828282828282828282828282828282828282828282828282828282828282828282828282828282828282828282828282828282828282828282828282828282828282828282828282828282828282828282828282828282828282828282828282828282828282828282828282828282828282828282828282828282828282828282828282828282828282828282828282828282828282828282828282828282828282828282828282828282828282828282828282828282828282828282828282828282828282828282828282828282828282828282828282828282828282828282828282828282828282828282828282828282828282828282828282828282828282828282828282828282000000000000000000000000000000000000000000000000000000000000000000000000000000000000000000000000000000000000000000000000000000000000000000000082
818181818181818181818181818181810000000000000000410000000000000000000000000000000000000000000000008200000000000000000000000082828282828282828282828282828282828282828282828282828282828282828282828282828282828282828282828282828282828282828282828282828282828282828282828282828282828282820000000000787878787878787878787878780000000000000000000000000000000000000000000000000000000000000000430000000000000000000000000000000000000000000000000000000000005700000000000000000000000000000000000000000000000000000000000000000000000000000000000000000000000000000000000000000000000000000000000000000000000000000000000082823000000000000000000000000000000000308200008282828282000000008282828282828282828282828230000000000000000000000000000000000000000000000000000030517475757575757575757575757575757600000000000000000000000000000000000000000000000000000000000000000000000000000000000000
818181818181818181818181818181810000000000000000410000000000000000000000000000000000000000000000008200000000000000000000000082000000000000000000000000000000000000000000000000000000000000000000000000000000000000000000000000000000000000000000000000000000000000000000000000000000000000820000000000780011000000780000000000780000000000000000000000000000000000000000000000000000000000000000430000000000000000000000000000000000000000000000000000000000005700000000000000000000000000000000000000000000000000000000000000000000000000000000000000000000000000000000000000000000000000000000000000000000000000000000000082823000000000000000000000000000000000308200008282828282000000008200000000828282000000008230000000000000000000000000000000000000000000000000000030510000000000000000000000000000007600000000000000000000000000000000000000000000000000000000000000000000000000000000000000
818181818181818181818181818181810000000000000000410000000000000000000000000000000000000000000000008200000000000000000000000082000000000000000000000000000000000000000000000000000000000000000000000000000000000000000000000000000000000000000000000000000000000000000000000000000082000000820000000000780000000000000078000000780000000000000000000000000000000000000000000000000000000000000000430000000000000000000000000000000000000000000000000000000000005700000057575757575700000000000000000000000000000000000000000000000000000000000000000000000000000000000000000000000000000000000000000000000000000000000000000082823000000000000000000000000000000000308200008200000000000000008200000000828282140000008230000000000000000000000000000000000000000000000000000030510000000000000000000000000000007600000000000000000000000000000000000000000000000000000000000000000000000000000000000000
818181818181818181818181818181810000000000004100410000000000000000000000000000000000000000000000008200000000000000000000000082000000000000000000000000000000000000000000000000000000000000000000000000000000000000000000000000000000000000000000000000000000000000000000000000820082820000820000000000780000787878787878000000780000000000000000000000000000000000000000000000000000000000004200430000000000000000005700000000000000005700000000000000000000005700575757000000005700000000000000000000000000000000000000000000000000000000000000000000000000000000000000000000000000000000000000000000000000000000000000000082823000000000303030303030303030303030308200008200000000008200008200828282828282828200008230000000000000000000000000000000000000000000000000000030510000000000000000000000000000007600000000000000000000000000000000000000000000000000000000000000000000000000000000000000
818181818181818181818181818181810000000000004100410000000000000000000000000000828200000000000000828200000000000000000000000082000000828282828282828282828282828282828282828282828282828282828282828282828282828282828282828282828282828282828282828282828282828282828282828282820000820000820000000000780000780000000078000000780000000000000000000000000000000000000000000000000000000000004200430000000000000000005700000000000000005700000000000000000000005700570000000000005700000000000000000000000000000000000000000000000000000000000000000000000000000000000000000000000000000000000000000000000000000000000000000082823030303030301313131313131313131313131300008200000000008200008200820000008282000000008230000000000000000000000000000000000000000000000000000030510000000000000000000000000000007600000000000000000000000000000000000000000000000000000000000000000000000000000000000000
818181818181818181818181818181810000414100004100000000000000000000000000000000008282000000000082820000000000000000000000000082000000000000000000000000000000000000000000000000000000000000000000000000000000000000000000000000820000000000000000000000000000000000000000000000000000820000820000000000780000780000000078780000780000000000000000000000000000000000000000000000000000000000004200430000000000000000005700000000000000005700000000000000000000005757570000000000005700000000000000000000000000000000000000000000000000000000000000000000000000000000000000000000000000000000000000000000000000000000000000000082823030131313131313303030303030303030308200008200000000828200008200000000008282000000008230000000000000000000000000000000000000000000000000000030510000000000000000000000000000007600000000000000000000000000000000000000000000000000000000000000000000000000000000000000
818181818181818181818181818181810000000000004141414100000000000000000000000000000082820000008282000000000000008282828282828282000000000000000000000000000000000000000000000000000000000000000000000000000000000000000000000000820000000000000000000000000000000000000000000000000000820000820000000000000000780078000078000078780000000000000000000000000000000000000000000000000000000000424200430000000000000000005700000000000000005700000000000000000000005700000000005700005700000000000000000000000000000000000000000000000000000000000000000000000000000000000000000000000000000000000000000000000000000000000000000082823030131330303030131330000000303030308200008200000000008200828200000000008282820000008230000000000000000000000000000000000000000000000000000030510000000000000000000000000000007600000000000000000000000000000000000000000000000000000000000000000000000000000000000000
818181818181818181818181818181810000000000000000004100000000000000000000000000000000828200828200000000000000008200000000000000000000000000000000000000000000000000000000000000000000000000000000000000000000000000000000000000000000000000000000000000000000000000000000000000000000820000820000000000780000780278000078780000780000000000000000000000000000000000000000000000000000000000424200430000000000000000005700000000000000005700000000000000000000005700005700005700005700000000000000000000000000000000000000000000000049490000000000000000000000000000000000000000000000000000000000000000000000000000000000000082823030301313131313131330303030301313308200008282000000008200820000000000008200000082008230000000000000000000000000000000000000000000000000000030510000000000000000000000000000007600000000000000000000000000000000000000000000000000000000000000000000000000000000000000
818181818181818181818181818181814141414100000000004100000000000000000000000000000000008200820000000000000000008200000000000000000082828282828282828282828282828282828282828282828282828282826970828282828282828282828282828282828282828282828282828282828282828282828282828282000000820000008200000000780000787878007878000078780000000000000000000000000000000000000000000000000000000042424200430000000069700000005757575757000000005757570000000000000000005700000000005700005700000000000000000000000000000000000000000000000000000000000000000000000000000000000000000000000000000049000000000000000000000000000000000082823000303030303030131313131313131313308200008200000000008200820000008200008200000082008230000000000000000000303030000000000000000000000000000030510000000000000000000000000000007600000000000000000000000000000000000000000000000000000000000000000000000000000000000000
818181818181818181818181818181810000004100000000004100747575757575757576000000000000008200820000008282828282828200000000000000000000000000000000000000000000000000000000000000000000000000007172000000000000000000000000000000000000000000000000000000000000000000000000000000000000820000000000000000780000000000000078780000780000000000000000000000000000000000000000000000000000000042424200430000000071720000005700001111000000000000000000000000000000000057575700005700005700000000000000000000000000000000000000000000000000000000000000490000000000000000000000000000000000000000000000000000000000000000000000000082823000000000000030303030303030303013308200008200000000008200820000008200008200008282008230303030003000303030300030303030303030303030303030303030510000000000000000000000000000007600000000000000000000000000000000000000000000000000000000000000000000000000000000000000
818181818181818181818181818181810000000000000000004100000000000000000000000000000000008200828282828200000000000000000000000000000000000000000000000000000000000000000000000000000000000000000000000000000000000000000000000000000000000000000000000000000000000000000000000000000000828282828282000000787878787878787878000000780000000000000000000000000000000000000000000000000000004242424200430000000000000000005700000000000000000000000000000000000000000000000000005700005700000000000000000000000000000000004949490000000000000000000000000000000000000000000000004900000000000000000000000000000000000000000000000082823000003030303030303030131313131313308200008200000082008200820000008200008200000082008249494949494949494949494949494949494949494949494949494949510000000000000000000000000000007651515151515151515151000000000000000000000000000000000000000000000000000000000000000000
191919191919191919191919191919190000000000000000004100000000000000000000000000000000008200000000000000000000000000000000000000000000000000000000000000000000000000000000000000000000000000000000000000000000000000000000000000000000000000000000000000000000000000000000000015000082820000000000000000000000000000000000000078780000000000000000000000000000000000000000000000000000004242424200430000000000000000005700000000000000000000000000000000000000005757575757575700005700000000000000000000000000000000000000000000000000000000000000000000000000000000000000000000000000000000000000000000000000000000000000000082823000003013131313131313131330303030308200000000000082828200820000828200008282000082000000000000000000000000000000000000000000000000000000000000000000000000000000000000000000000000000000000000000051000000000000000000000000000000000000000000000000000000000000000000
000000002800000000000000000000000000000000000041414100000000000000000000000000000000008282828282828282828282828282828282828282828282828282828282828282828282828282828282828282828282828282828282828282828282828282828282828282828282828282828282828282828282828282828282828282828200000000000000000000000000000000000000000000000000000082828282820000000000000000000000000000000000004242424200430000000000000000005700000000000000000000000000000000000000575700000000000000000000000000000000000049494949490000000000000000000000000000000000000000000000004900000000000000000000000000000000000000004900000000000000000082823030303013133030303030303030000000308200000000008282828200000082828200008200000082000000000000000000000000000000000000000000000000000000000000000000000000000000000000000000000000000000000000000051515151515151515151515151515151515151515151515151515151515151000000
202020202020202020202020202020200000000000000000004100000000000000000000000000000000008282828282828200000000000000000000000000000000000000000000000000000000000000000000000000000000000000000000000000000000000000000000000000000000000000000000000000000000000000000000000000000000000000000000000000787878787878787878787878780000000000000000000000000000000000000000000000000000004242424200000000000000000000005710101010101010101010101010101010101057575700160000000000000000000000004900000000000000000000000000000000000000000000000000000000000000000000000000000000000000000000000000000000000000000000000000000013131313131313133000000000000000000000308200000000008282828200000082828200000000008282000000000000000000000000000000000000000000000000000000000000000000000000000000000000000000000000000000000000050000280000000000000029000000000000000000000000000000000000000000000000
494949494949494949494949494949494949494949494949494949494949494949494949494949494949494949494949494909090909090909090909090909090909090909090909090909090909090909090909090909090909090909090909090909090909090909090909090909090909090909090909090909090909090909090909090909090909090909090949494949494949494949494949494949494949494949494949494909090909094949090909090949494949494949494949494949494949494949494959595959595959595959595959595959595957575749494949494949494949494949494961616161616161616161616161616161616161616161616161616161616161616161616161616161616161616161616161616161616161616161616149494949494949494949494949494949494949494949494949494949494949494949494949494949494949494949494949494949494949494949494949494949494949494949494949494949517475757575757575757575757575757651515151515151515151515151515151515151515151515151515151515151515151515151515151000000
#
#
