###Map Created with PsychoStrain Map Editor RC3
#
#
XXXXXXXXXXXXXXXXXXXXXXXXXXXXXXXXXXXXXXXXXXXXXXXXXXXX
0000000000000000000000000000000000000000000000000000
0000000000000000000000000000000000490000000000000000
0000000000000000000000000000000000490000000000000000
0000000000000000000000000000000000490000000000000000
0000004900004949000000000000000000490000000000000000
0000004900004949000000000000000000490000000000000000
0000004900004949000000000000000000490000000000000000
0000004900004949000000000000000000490000000000000000
0000004900000000000000000000000000490000000000000000
0000004949494900000000000000000000490000000000000000
0000000000000000000000000000000000490000000000000000
0000000000000000000000000000000000490000000000000000
0000000000000000000000000000000000490000000000000000
0000000000000000000000000000000005490000000000000000
4949494949494949494949494949494949490000000000000000
0000000000000000000000000000000000000000000000000000
#
#
